####################
#              #####
#                ###
#       ###       ##
#       #F#        #
#                  #
#              T   #
#                  #
#                  #
#                  #
#                  #
#    C             #
#                  #
#                  #
##                 #
###                #
######             #
########           #
###########        #
####################