####################
#######      #######
####           #####
##    T         ####
#               ####
#        #        ##
F        #       ###
#        #      ####
#       #       ####
#                ###
##    C#          ##
####          ######
######       #######
########    ########
####################
####################
####################
####################
####################
####################