####################
####################
####            ####
##                ##
#        T         #
#                  #
#        ##        #
##     # ## #     ##
##       ##       C#
##     # ## #     ##
#        ##        #
#                  #
#                  #
#                  #
###              ###
#######  F  ########
####################
####################
####################
####################