####################
#######        #####
####             ###
##                 #
#                  #
#           ##     #
#    #     #      ##
#   # T           F#
#    #            ##
#          #       #
#           ##     #
#                  #
#                  #
###    ###         #
#        #         #
#   C    #         #
#        #         #
####################
####################
####################