####F#####
#        #
#        #
#        #
#        #
#       T#
#        #
#        #
#C       #
##########