####F#####
#        #
#        #
#        #
# C      #
#        #
#     T  #
#        #
#        #
##########