####F#####
#        #
#        #
#        #
# C T    #
#        #
#        #
#        #
#        #
##########